{
  "stage": "4H.5",
  "run_level_by_raw": {
    "0": 0,
    "19": 1,
    "20": 1,
    "21": 1,
    "22": 1,
    "23": 1,
    "24": 1,
    "25": 1,
    "26": 1,
    "27": 1,
    "28": 2,
    "29": 3,
    "31": 1,
    "32": 1,
    "33": 1,
    "34": 1,
    "35": 1,
    "36": 1,
    "37": 1,
    "38": 1
  },
  "unknown_raw_maps_to": 3
}
