[
  {
    "schema": "simurgh.ccb.cluster_merge_event.v1",
    "sequence": 1,
    "parent_event_digest": null,
    "old_graph_version_digest": "sha256:eeeeeeeeeeeeeeeeeeeeeeeeeeeeeeeeeeeeeeeeeeeeeeeeeeeeeeeeeeeeeeee",
    "new_graph_version_digest": "sha256:ffffffffffffffffffffffffffffffffffffffffffffffffffffffffffffffff",
    "merges": [
      {
        "new_cluster_commitment": "sha256:dddddddddddddddddddddddddddddddddddddddddddddddddddddddddddddddd",
        "new_budget": 5,
        "merged_cluster_commitments": [
          "sha256:0000000000000000000000000000000000000000000000000000000000000000",
          "sha256:0101010101010101010101010101010101010101010101010101010101010101",
          "sha256:0202020202020202020202020202020202020202020202020202020202020202",
          "sha256:0303030303030303030303030303030303030303030303030303030303030303",
          "sha256:0404040404040404040404040404040404040404040404040404040404040404",
          "sha256:0505050505050505050505050505050505050505050505050505050505050505",
          "sha256:0606060606060606060606060606060606060606060606060606060606060606",
          "sha256:0707070707070707070707070707070707070707070707070707070707070707",
          "sha256:0808080808080808080808080808080808080808080808080808080808080808",
          "sha256:0909090909090909090909090909090909090909090909090909090909090909",
          "sha256:0a0a0a0a0a0a0a0a0a0a0a0a0a0a0a0a0a0a0a0a0a0a0a0a0a0a0a0a0a0a0a0a",
          "sha256:0b0b0b0b0b0b0b0b0b0b0b0b0b0b0b0b0b0b0b0b0b0b0b0b0b0b0b0b0b0b0b0b",
          "sha256:0c0c0c0c0c0c0c0c0c0c0c0c0c0c0c0c0c0c0c0c0c0c0c0c0c0c0c0c0c0c0c0c",
          "sha256:0d0d0d0d0d0d0d0d0d0d0d0d0d0d0d0d0d0d0d0d0d0d0d0d0d0d0d0d0d0d0d0d",
          "sha256:0e0e0e0e0e0e0e0e0e0e0e0e0e0e0e0e0e0e0e0e0e0e0e0e0e0e0e0e0e0e0e0e",
          "sha256:0f0f0f0f0f0f0f0f0f0f0f0f0f0f0f0f0f0f0f0f0f0f0f0f0f0f0f0f0f0f0f0f",
          "sha256:1010101010101010101010101010101010101010101010101010101010101010",
          "sha256:1111111111111111111111111111111111111111111111111111111111111111",
          "sha256:1212121212121212121212121212121212121212121212121212121212121212",
          "sha256:1313131313131313131313131313131313131313131313131313131313131313",
          "sha256:1414141414141414141414141414141414141414141414141414141414141414",
          "sha256:1515151515151515151515151515151515151515151515151515151515151515",
          "sha256:1616161616161616161616161616161616161616161616161616161616161616",
          "sha256:1717171717171717171717171717171717171717171717171717171717171717",
          "sha256:1818181818181818181818181818181818181818181818181818181818181818",
          "sha256:1919191919191919191919191919191919191919191919191919191919191919",
          "sha256:1a1a1a1a1a1a1a1a1a1a1a1a1a1a1a1a1a1a1a1a1a1a1a1a1a1a1a1a1a1a1a1a",
          "sha256:1b1b1b1b1b1b1b1b1b1b1b1b1b1b1b1b1b1b1b1b1b1b1b1b1b1b1b1b1b1b1b1b",
          "sha256:1c1c1c1c1c1c1c1c1c1c1c1c1c1c1c1c1c1c1c1c1c1c1c1c1c1c1c1c1c1c1c1c",
          "sha256:1d1d1d1d1d1d1d1d1d1d1d1d1d1d1d1d1d1d1d1d1d1d1d1d1d1d1d1d1d1d1d1d",
          "sha256:1e1e1e1e1e1e1e1e1e1e1e1e1e1e1e1e1e1e1e1e1e1e1e1e1e1e1e1e1e1e1e1e",
          "sha256:1f1f1f1f1f1f1f1f1f1f1f1f1f1f1f1f1f1f1f1f1f1f1f1f1f1f1f1f1f1f1f1f",
          "sha256:2020202020202020202020202020202020202020202020202020202020202020",
          "sha256:2121212121212121212121212121212121212121212121212121212121212121",
          "sha256:2222222222222222222222222222222222222222222222222222222222222222",
          "sha256:2323232323232323232323232323232323232323232323232323232323232323",
          "sha256:2424242424242424242424242424242424242424242424242424242424242424",
          "sha256:2525252525252525252525252525252525252525252525252525252525252525",
          "sha256:2626262626262626262626262626262626262626262626262626262626262626",
          "sha256:2727272727272727272727272727272727272727272727272727272727272727",
          "sha256:2828282828282828282828282828282828282828282828282828282828282828",
          "sha256:2929292929292929292929292929292929292929292929292929292929292929",
          "sha256:2a2a2a2a2a2a2a2a2a2a2a2a2a2a2a2a2a2a2a2a2a2a2a2a2a2a2a2a2a2a2a2a",
          "sha256:2b2b2b2b2b2b2b2b2b2b2b2b2b2b2b2b2b2b2b2b2b2b2b2b2b2b2b2b2b2b2b2b",
          "sha256:2c2c2c2c2c2c2c2c2c2c2c2c2c2c2c2c2c2c2c2c2c2c2c2c2c2c2c2c2c2c2c2c",
          "sha256:2d2d2d2d2d2d2d2d2d2d2d2d2d2d2d2d2d2d2d2d2d2d2d2d2d2d2d2d2d2d2d2d",
          "sha256:2e2e2e2e2e2e2e2e2e2e2e2e2e2e2e2e2e2e2e2e2e2e2e2e2e2e2e2e2e2e2e2e",
          "sha256:2f2f2f2f2f2f2f2f2f2f2f2f2f2f2f2f2f2f2f2f2f2f2f2f2f2f2f2f2f2f2f2f",
          "sha256:3030303030303030303030303030303030303030303030303030303030303030",
          "sha256:3131313131313131313131313131313131313131313131313131313131313131",
          "sha256:3232323232323232323232323232323232323232323232323232323232323232",
          "sha256:3333333333333333333333333333333333333333333333333333333333333333",
          "sha256:3434343434343434343434343434343434343434343434343434343434343434",
          "sha256:3535353535353535353535353535353535353535353535353535353535353535",
          "sha256:3636363636363636363636363636363636363636363636363636363636363636",
          "sha256:3737373737373737373737373737373737373737373737373737373737373737",
          "sha256:3838383838383838383838383838383838383838383838383838383838383838",
          "sha256:3939393939393939393939393939393939393939393939393939393939393939",
          "sha256:3a3a3a3a3a3a3a3a3a3a3a3a3a3a3a3a3a3a3a3a3a3a3a3a3a3a3a3a3a3a3a3a",
          "sha256:3b3b3b3b3b3b3b3b3b3b3b3b3b3b3b3b3b3b3b3b3b3b3b3b3b3b3b3b3b3b3b3b",
          "sha256:3c3c3c3c3c3c3c3c3c3c3c3c3c3c3c3c3c3c3c3c3c3c3c3c3c3c3c3c3c3c3c3c",
          "sha256:3d3d3d3d3d3d3d3d3d3d3d3d3d3d3d3d3d3d3d3d3d3d3d3d3d3d3d3d3d3d3d3d",
          "sha256:3e3e3e3e3e3e3e3e3e3e3e3e3e3e3e3e3e3e3e3e3e3e3e3e3e3e3e3e3e3e3e3e",
          "sha256:3f3f3f3f3f3f3f3f3f3f3f3f3f3f3f3f3f3f3f3f3f3f3f3f3f3f3f3f3f3f3f3f",
          "sha256:4040404040404040404040404040404040404040404040404040404040404040",
          "sha256:4141414141414141414141414141414141414141414141414141414141414141",
          "sha256:4242424242424242424242424242424242424242424242424242424242424242",
          "sha256:4343434343434343434343434343434343434343434343434343434343434343",
          "sha256:4444444444444444444444444444444444444444444444444444444444444444",
          "sha256:4545454545454545454545454545454545454545454545454545454545454545",
          "sha256:4646464646464646464646464646464646464646464646464646464646464646",
          "sha256:4747474747474747474747474747474747474747474747474747474747474747",
          "sha256:4848484848484848484848484848484848484848484848484848484848484848",
          "sha256:4949494949494949494949494949494949494949494949494949494949494949",
          "sha256:4a4a4a4a4a4a4a4a4a4a4a4a4a4a4a4a4a4a4a4a4a4a4a4a4a4a4a4a4a4a4a4a",
          "sha256:4b4b4b4b4b4b4b4b4b4b4b4b4b4b4b4b4b4b4b4b4b4b4b4b4b4b4b4b4b4b4b4b",
          "sha256:4c4c4c4c4c4c4c4c4c4c4c4c4c4c4c4c4c4c4c4c4c4c4c4c4c4c4c4c4c4c4c4c",
          "sha256:4d4d4d4d4d4d4d4d4d4d4d4d4d4d4d4d4d4d4d4d4d4d4d4d4d4d4d4d4d4d4d4d",
          "sha256:4e4e4e4e4e4e4e4e4e4e4e4e4e4e4e4e4e4e4e4e4e4e4e4e4e4e4e4e4e4e4e4e",
          "sha256:4f4f4f4f4f4f4f4f4f4f4f4f4f4f4f4f4f4f4f4f4f4f4f4f4f4f4f4f4f4f4f4f",
          "sha256:5050505050505050505050505050505050505050505050505050505050505050",
          "sha256:5151515151515151515151515151515151515151515151515151515151515151",
          "sha256:5252525252525252525252525252525252525252525252525252525252525252",
          "sha256:5353535353535353535353535353535353535353535353535353535353535353",
          "sha256:5454545454545454545454545454545454545454545454545454545454545454",
          "sha256:5555555555555555555555555555555555555555555555555555555555555555",
          "sha256:5656565656565656565656565656565656565656565656565656565656565656",
          "sha256:5757575757575757575757575757575757575757575757575757575757575757",
          "sha256:5858585858585858585858585858585858585858585858585858585858585858",
          "sha256:5959595959595959595959595959595959595959595959595959595959595959",
          "sha256:5a5a5a5a5a5a5a5a5a5a5a5a5a5a5a5a5a5a5a5a5a5a5a5a5a5a5a5a5a5a5a5a",
          "sha256:5b5b5b5b5b5b5b5b5b5b5b5b5b5b5b5b5b5b5b5b5b5b5b5b5b5b5b5b5b5b5b5b",
          "sha256:5c5c5c5c5c5c5c5c5c5c5c5c5c5c5c5c5c5c5c5c5c5c5c5c5c5c5c5c5c5c5c5c",
          "sha256:5d5d5d5d5d5d5d5d5d5d5d5d5d5d5d5d5d5d5d5d5d5d5d5d5d5d5d5d5d5d5d5d",
          "sha256:5e5e5e5e5e5e5e5e5e5e5e5e5e5e5e5e5e5e5e5e5e5e5e5e5e5e5e5e5e5e5e5e",
          "sha256:5f5f5f5f5f5f5f5f5f5f5f5f5f5f5f5f5f5f5f5f5f5f5f5f5f5f5f5f5f5f5f5f",
          "sha256:6060606060606060606060606060606060606060606060606060606060606060",
          "sha256:6161616161616161616161616161616161616161616161616161616161616161",
          "sha256:6262626262626262626262626262626262626262626262626262626262626262",
          "sha256:6363636363636363636363636363636363636363636363636363636363636363"
        ],
        "merge_basis": [
          "payment_graph"
        ]
      }
    ],
    "carried_cluster_commitments": [],
    "raw_identity_exported": false
  }
]
